p	p
b	b
t	t
d	d
k	k
g	g
m	m
n	n
ng	ŋ
r	ʁ
v	v
f	f
s	s
z	z
sch	ʃ
ch	x
h	h
l	l
i	iː
y	yː
ÿ	ʏ
e	eː
a	aː
ä	ɛ
u	uː
o	oː
ei	aɪ
au	aʊ
eu	ɔɪ
c	c
w	v
j	j
